      월요일 화요일 수요일 목요일 금요일
1교시  수학   과학   영어   국어  사회
2교시  수학   과학   영어   국어  사회
3교시  수학   과학   영어   국어  사회
4교시  수학   과학   영어   국어  사회
5교시  수학   과학   영어   국어  사회
6교시  수학   과학   영어   국어  사회
7교시  수학   과학   영어   국어  사회
