{
    "월": {
        "1": ["과학 (김유경)","과학 (김현옥)"],
        "2": ["일어 (박남희)"],
        "3": ["문학 (윤진서)"],
        "4": ["운동 (안진호)"],
        "5": ["영어 (이민근)"],
        "6": ["수1 (안유진)"],
        "7": ["국사 (이상섭)"]
    },
    "화": {
        "1": ["영어 (김아리)"],
        "2": ["미술 (김응진)"],
        "3": ["미술 (김응진)"],
        "4": ["수2 (배병규)"],
        "5": ["과학 (김현옥)","과학 (김유경)"],
        "6": ["수1 (안유진)"],
        "7": ["창체 (김유경)"]
    },
    "수": {
        "1": ["수1 (안유진)"],
        "2": ["과학 (김유경)","과학 (김현옥)"],
        "3": ["문학 (조태현)"],
        "4": ["영어 (박선희)"],
        "5": ["국사 (이상섭)"],
        "6": ["수2 (배병규)"],
        "7": ["창체 (배영진)"]
    },
    "목": {
        "1": ["운동 (안진호)"],
        "2": ["생과 (김유경)"],
        "3": ["사탐 (서유경)"],
        "4": ["독서 (윤진서)"],
        "5": ["과학 (김현정)"],
        "6": ["화작 (김형성)"],
        "7": ["미적 (안유진)"]
    },
    "금": {
        "1": ["사탐 (서유경)"],
        "2": ["수2 (배병규)"],
        "3": ["수1 (안유진)"],
        "4": ["문학 (조태현)"],
        "5": ["자율"],
        "6": ["동아리"],
        "7": [""]
    }
}