{
    "월": {
        "1": "과학 (김유경)",
        "2": "일어 (박남희)",
        "3": "문학 (윤진서)",
        "4": "운동 (안진호)",
        "5": "영어 (이민근)",
        "6": "수1 (안유진)",
        "7": "국사 (이상섭)"
    },
    "화": {
        "1": "영어 (김아리)",
        "2": "미술 (김응진)",
        "3": "미술 (김응진)",
        "4": "수2 (배병규)",
        "5": "과학 (김현옥)",
        "6": "수1 (안유진)",
        "7": "창체 (김유경)"
    },
    "수": {
        "1": "수1 (안유진)",
        "2": "과학 (김유경)",
        "3": "문학 (조태현)",
        "4": "영어 (박선희)",
        "5": "국사 (이상섭)",
        "6": "수2 (배병규)",
        "7": "창체 (배영진)"
    },
    "목": {
        "1": "운동 (안진호)",
        "2": "영어 (김아리)",
        "3": "과학 (김현옥)",
        "4": "수2 (배병규)",
        "5": "문학 (윤진서)",
        "6": "생과 (배영진)",
        "7": "일어 (박남희)"
    },
    "금": {
        "1": "사탐 (서유경)",
        "2": "수2 (배병규)",
        "3": "수1 (안유진)",
        "4": "문학 (조태현)",
        "5": "자율",
        "6": "동아리",
        "7": ""
    }
}