{
    "월": {
        "1": "과학 (김현경)",
        "2": "수1 (안유진)",
        "3": "문학 (조태현)",
        "4": "사탐 (서유경)",
        "5": "영어 (박선희)",
        "6": "일어 (박남희)",
        "7": "수2 (박현옥)"
    },
    "화": {
        "1": "문학 (윤진서)",
        "2": "영어 (김아리)",
        "3": "수2 (박현옥)",
        "4": "운동 (안진호)",
        "5": "과학 (신정의)",
        "6": "국사 (이상섭)",
        "7": "창체 (안유진)"
    },
    "수": {
        "1": "영어 (이민근)",
        "2": "과학 (김현정)",
        "3": "운동 (안진호)",
        "4": "수1 (안유진)",
        "5": "문학 (조태현)",
        "6": "수2 (박현옥)",
        "7": "창체 (윤창영)"
    },
    "목": {
        "1": "미술 (김응진)",
        "2": "미술 (김응진)",
        "3": "과학 (신정의)",
        "4": "생과 (배영진)",
        "5": "수1 (안유진)",
        "6": "영어 (김아리)",
        "7": "문학 (윤진서)"
    },
    "금": {
        "1": "국사 (이상섭)",
        "2": "수2 (박현옥)",
        "3": "일어 (박남희)",
        "4": "수1 (안유진)",
        "5": "자율",
        "6": "동아리",
        "7": ""
    }
}