{
    "월": {
        "1": "과학 (신정의)",
        "2": "사탐 (서유경)",
        "3": "수1 (석은주)",
        "4": "수2 (박현옥)",
        "5": "미술 (김응진)",
        "6": "미술 (김응진)",
        "7": "문학 (조태현)"
    },
    "화": {
        "1": "일어 (박남희)",
        "2": "영어 (박선희)",
        "3": "수1 (석은주)",
        "4": "생과 (배영진)",
        "5": "과학 (김현정)",
        "6": "문학 (윤진서)",
        "7": "창체 (김아리)"
    },
    "수": {
        "1": "수2 (박현옥)",
        "2": "과학 (신정의)",
        "3": "영어 (김아리)",
        "4": "운동 (안진호)",
        "5": "영어 (이민근)",
        "6": "국사 (이상섭)",
        "7": "창체 (김아리)"
    },
    "목": {
        "1": "국사 (이상섭)",
        "2": "문학 (윤진서)",
        "3": "과학 (김현정)",
        "4": "문학 (조태현)",
        "5": "운동 (안진호)",
        "6": "수1 (석은주)",
        "7": "수2 (박현옥)"
    },
    "금": {
        "1": "영어 (김아리)",
        "2": "수1 (석은주)",
        "3": "수2 (박현옥)",
        "4": "일어 (박남희)",
        "5": "자율",
        "6": "동아리",
        "7": ""
    }
}