{
    "월": {
        "1": ["과학 (신정의)","과학 (김재영)"],
        "2": ["화작 (김윤지)"],
        "3": ["독서 (윤진서)"],
        "4": ["영어 (박선희)"],
        "5": ["미적 (안유진)"],
        "6": ["운동 (김인수)"],
        "7": ["일어 (박남희)"]
    },
    "화": {
        "1": ["영어 (김아리)"],
        "2": ["미적 (안유진)"],
        "3": ["과학 (김현정)", "과학 (김재영)"],
        "4": ["국사 (이상섭)"],
        "5": ["미술 (김응진)"],
        "6": ["미술 (김응진)"],
        "7": ["자율 (김유경)"]
    },
    "수": {
        "1": ["독서 (조태현)"],
        "2": ["일어 (박남희)"],
        "3": ["미적 (안유진)"],
        "4": ["화작 (김형성)"],
        "5": ["영어 (박선희)"],
        "6": ["국사 (이상섭)"],
        "7": ["과학 (신정의)", "과학 (김재영)"]
    },
    "목": {
        "1": ["운동 (안진호)"],
        "2": ["생과 (김유경)"],
        "3": ["사탐 (서유경)"],
        "4": ["독서 (윤진서)"],
        "5": ["과학 (김현정)"],
        "6": ["화작 (김형성)"],
        "7": ["미적 (안유진)"]
    },
    "금": {
        "1": ["영어 (김아리)"],
        "2": ["독서 (조태현)"],
        "3": ["화작 (김형성)"],
        "4": ["자율 (김유경)"],
        "5": ["자율"],
        "6": ["동아리"],
        "7": [""]
    }
}