{
    "월": {
        "1": "문학 (윤진서)",
        "2": "사회 (홍준표)",
        "3": "수1 (안유진)",
        "4": "화작 (김형성)",
        "5": "일어 (박남희)",
        "6": "운동 (안진호)",
        "7": "영어 (이민근)"
    },
    "화": {
        "1": "사회 (홍준표)",
        "2": "국사 (이상섭)",
        "3": "수1 (안유진)",
        "4": "문학 (조태현",
        "5": "영어 (김아리)",
        "6": "화작 (김형성)",
        "7": "창체 (조태현)"
    },
    "수": {
        "1": "운동 (안진호)",
        "2": "수1 (안유진)",
        "3": "화작 (김형성)",
        "4": "문학 (윤진서)",
        "5": "영어 (박선희)",
        "6": "사탐 (서유경)",
        "7": "창체 (박선희)"
    },
    "목": {
        "1": "생과 (배영진)",
        "2": "국사 (이상섭)",
        "3": "일어 (박남희)",
        "4": "사회 (홍준표)",
        "5": "화작 (김형성)",
        "6": "문학 (조태현)",
        "7": "수1 (안유진)"
    },
    "금": {
        "1": "영어 (이민근)",
        "2": "사회 (홍준표)",
        "3": "미술 (김응진)",
        "4": "미술 (김응진)",
        "5": "자율",
        "6": "동아리",
        "7": ""
    }
}