{
    "월": {
        "1": "문학 (조태현)",
        "2": "사회 (김송하)",
        "3": "화작 (김형성)",
        "4": "영어 (김아리)",
        "5": "생과 (배영진)",
        "6": "수1 (김기홍)",
        "7": "운동 (안진호)"
    },
    "화": {
        "1": "사회 (김송하)",
        "2": "사탐 (서유경)",
        "3": "영어 (박선희)",
        "4": "국사 (이상섭)",
        "5": "화작 (김형성)",
        "6": "영어 (이민근)",
        "7": "창체 (서유경)"
    },
    "수": {
        "1": "문학 (윤진서)",
        "2": "수1 (김기홍)",
        "3": "미술 (김응진)",
        "4": "미술 (김응진)",
        "5": "중어 (서유리)",
        "6": "중어 (서유리)",
        "7": "창체 (이민근)"
    },
    "목": {
        "1": "화작 (김형성)",
        "2": "문학 (조태현)",
        "3": "수1 (김기홍)",
        "4": "사회 (김송하)",
        "5": "국사 (이상섭)",
        "6": "영어 (이민근)",
        "7": "운동 (안진호)"
    },
    "금": {
        "1": "화작 (김형성)",
        "2": "사회 (김송하)",
        "3": "문학 (윤진서)",
        "4": "수1 (김기홍)",
        "5": "자율",
        "6": "동아리",
        "7": ""
    }
}